8 8 8 8 8 8 8 8 8 8 8 8 8 8 8 8
8 0 0 6 0 6 0 6 0 6 0 0 6 2 0 8
8 0 0 6 6 6 6 6 6 6 6 6 6 0 0 8
8 6 6 8 2 0 8 3 0 8 2 0 8 0 0 8
8 0 0 6 0 0 6 0 0 6 0 0 6 0 3 8
8 6 6 6 0 0 6 0 0 6 0 0 6 0 0 8
8 6 6 8 6 6 8 6 6 8 6 6 8 0 0 8
8 6 6 6 0 0 6 6 6 6 3 0 6 6 6 8
8 0 0 6 0 0 6 6 6 6 0 0 6 6 0 8
8 0 0 8 6 6 8 6 6 8 6 6 8 0 0 8
8 6 6 6 2 0 6 3 0 6 2 0 6 6 6 8
8 0 0 6 0 0 6 0 0 6 0 0 6 6 6 8
8 0 0 8 0 0 8 0 0 8 0 0 8 2 0 8
8 0 0 6 6 6 6 6 6 6 6 6 6 0 0 8
8 2 0 6 0 6 0 6 0 6 0 6 0 0 0 8
8 8 8 8 8 8 8 8 8 8 8 8 8 8 8 8